20 20 20 20 20 20 20 20 20 20 20 20 20 20 20 20 22 17 17 17 23 20 20 20 20 20 20 20 20 20 20 20 20 20 20 20 20 20 20 20 20 20 20 20 20 20 20 20 20 20 20 20 20 20 20 20 20 20 20 20 20 20 20 20 20 20 20 20 20 20 20 20 20 20 20 20 20 20 20 20 20 20 20 20 20 20 20 20 20 20 20 20 20 20 20 20 20 20 20 20
20 20 20 20 20 20 20 20 20 20 20 20 20 20 22 17 18 0 0 0 16 17 17 17 23 20 20 20 20 20 20 20 20 20 20 20 20 20 20 20 20 20 20 20 20 20 20 20 20 20 20 20 20 20 20 20 20 20 20 20 20 20 20 20 20 20 20 20 20 20 20 20 20 20 20 20 20 20 20 20 20 20 20 20 20 20 20 20 20 20 20 20 20 20 20 20 20 20 20 20
20 20 20 20 20 20 20 20 20 20 20 20 22 17 18 0 0 0 0 0 0 0 0 0 16 17 23 20 20 20 20 20 20 20 20 20 20 20 20 20 20 20 20 20 20 20 20 20 20 20 20 20 20 20 20 20 20 20 20 20 20 20 20 20 20 20 20 20 20 20 20 20 20 20 20 20 20 20 20 20 20 20 20 20 20 20 20 20 20 20 20 20 20 20 20 20 20 20 20 20
20 20 20 20 20 20 20 20 20 20 20 22 18 0 0 0 0 0 0 0 0 0 0 0 0 0 16 17 17 17 23 20 20 20 20 20 20 20 20 20 20 20 20 20 20 22 17 17 23 20 20 20 20 20 20 20 20 20 20 20 20 20 20 20 20 20 20 20 20 20 20 20 20 20 20 20 20 20 20 20 20 20 20 20 20 20 20 20 20 20 20 20 20 20 20 20 20 20 20 20
20 20 20 20 20 20 20 22 17 17 17 18 0 0 0 0 0 0 0 0 0 0 0 0 0 0 0 0 0 0 16 17 17 17 17 23 20 20 20 20 20 20 20 22 17 18 0 0 16 17 17 17 23 20 20 20 20 20 20 20 20 20 20 20 20 20 20 20 20 20 20 20 20 20 20 20 20 20 20 20 20 20 20 20 20 20 20 20 22 17 17 23 20 20 20 20 20 20 20 20
20 20 20 22 17 17 17 18 0 0 0 0 0 0 0 0 0 0 0 0 0 0 0 0 0 0 0 0 0 0 0 0 0 0 0 16 17 17 17 17 17 17 17 18 0 0 0 0 0 0 0 0 16 17 17 17 23 20 20 20 20 20 20 20 20 20 20 20 20 20 20 20 20 20 20 20 20 20 20 20 20 20 20 20 20 20 20 22 18 0 0 16 23 20 20 20 20 20 20 20
20 22 17 18 11 12 12 12 12 12 13 0 0 0 0 0 0 0 0 0 0 0 0 0 0 0 0 0 0 0 0 0 0 0 0 0 0 0 0 0 0 0 0 0 0 0 0 0 0 0 0 0 0 0 0 0 16 17 17 23 20 20 22 17 17 23 20 20 20 20 20 20 20 20 20 20 20 20 20 20 20 20 20 20 20 20 22 18 0 0 0 0 16 17 17 23 20 20 20 20
20 24 13 11 25 20 20 20 20 20 24 13 0 0 0 0 0 0 0 0 0 0 0 0 0 0 0 0 0 0 0 0 0 0 0 0 0 0 0 0 0 0 0 0 0 0 0 0 0 0 0 0 0 0 0 0 0 0 0 16 17 17 18 0 0 14 20 20 20 20 20 20 20 20 20 20 20 20 20 20 20 20 20 20 20 22 18 0 0 0 0 0 0 0 0 16 17 17 23 20
20 20 15 14 20 20 20 20 20 20 20 24 13 0 0 0 0 0 0 0 0 0 0 0 0 0 0 0 0 0 0 0 0 0 0 0 0 0 0 0 0 0 0 0 0 0 0 0 0 0 0 0 0 0 0 0 0 0 0 0 0 0 0 0 11 25 20 20 20 20 20 20 20 20 20 20 20 20 20 20 20 20 20 20 20 24 13 0 0 0 0 0 0 0 0 0 0 0 14 20
20 20 24 25 20 20 20 20 20 20 20 20 24 13 0 0 0 0 0 0 0 0 0 0 0 0 0 0 0 0 0 0 0 0 0 0 0 0 0 0 0 0 0 0 0 0 0 0 0 0 0 0 0 0 0 0 0 0 0 0 0 0 0 0 14 20 20 20 20 20 20 20 20 20 20 20 20 20 20 20 20 20 20 20 20 20 15 0 0 0 0 0 0 0 0 0 0 0 14 20
20 20 20 20 20 20 20 20 20 20 20 20 20 15 0 0 0 0 0 0 0 0 0 0 0 0 0 0 0 0 0 0 0 0 0 0 0 0 0 0 0 0 0 0 0 0 0 0 0 0 0 0 0 0 0 0 0 0 0 0 0 0 0 0 16 17 23 20 20 20 20 20 20 20 20 20 20 20 20 20 20 20 20 20 20 20 24 13 0 0 0 0 0 0 0 0 0 0 14 20
20 20 20 20 20 20 20 20 20 20 20 20 22 18 0 0 0 0 0 0 0 0 0 0 0 0 0 0 0 0 0 0 0 0 0 0 0 0 0 0 0 0 0 0 0 0 0 0 0 0 0 0 0 0 0 0 0 0 0 0 0 0 0 0 0 0 16 23 20 20 20 20 20 20 20 20 20 20 20 20 20 20 20 20 20 20 20 24 13 0 0 0 0 0 0 0 0 11 25 20
20 20 20 20 20 20 20 20 20 20 20 22 18 0 0 0 0 0 0 0 0 0 0 0 0 0 0 0 0 0 0 0 0 0 0 0 0 0 0 0 0 0 0 0 0 0 0 0 0 0 0 0 0 0 0 0 0 0 0 0 0 0 0 0 0 0 11 25 20 20 20 20 20 20 20 20 20 20 20 20 20 20 20 20 20 20 20 20 15 0 0 0 0 0 0 0 11 25 20 20
20 20 20 20 20 20 20 20 20 22 17 18 0 0 0 0 0 0 0 0 0 0 0 0 0 0 0 0 0 0 0 0 0 0 0 0 0 0 0 0 0 0 0 0 0 0 0 0 0 0 0 0 0 0 0 0 0 0 0 0 0 0 0 0 0 11 25 20 20 20 20 20 20 20 20 20 20 20 20 20 20 20 20 20 20 20 20 20 24 13 0 0 0 0 0 11 25 20 20 20
20 20 20 20 20 20 20 22 17 18 0 0 0 0 0 0 0 0 0 0 0 0 0 0 0 0 0 0 0 0 0 0 0 0 0 0 0 0 0 0 0 0 0 0 0 0 0 0 0 0 0 0 0 0 0 0 0 0 0 0 0 0 0 11 12 25 20 20 20 20 20 20 20 20 20 20 20 20 20 20 20 20 20 20 20 20 20 20 20 15 0 0 0 0 0 14 20 20 20 20
20 20 20 20 22 17 17 18 0 0 0 0 0 0 0 0 0 0 0 0 0 0 0 0 0 0 0 0 0 0 0 0 0 0 0 0 0 0 0 0 0 0 0 0 0 0 0 0 0 0 0 0 0 0 0 0 0 0 0 0 0 0 11 25 20 20 20 20 20 20 20 20 20 20 20 20 20 20 20 20 20 20 20 20 20 20 20 22 17 18 0 0 0 0 0 16 23 20 22 23
20 20 22 17 18 0 0 0 0 0 0 0 0 0 0 0 0 0 0 0 0 0 0 0 0 0 0 0 0 0 0 0 0 0 0 0 0 0 0 0 0 0 0 0 0 0 0 0 0 0 0 0 0 0 0 0 0 0 0 0 0 11 25 20 20 20 20 20 20 20 20 20 20 20 20 20 20 20 20 20 20 20 20 20 20 20 22 18 0 0 0 0 0 0 11 12 25 20 15 14
20 22 18 0 0 0 0 0 0 0 0 0 0 0 0 0 0 0 0 0 0 0 0 0 0 0 0 0 0 0 0 0 0 0 0 0 0 0 0 0 0 0 0 0 0 0 0 0 0 0 0 0 0 0 0 0 0 0 0 0 0 14 20 20 20 20 20 20 20 20 20 20 20 20 20 20 20 20 20 20 20 20 20 20 20 22 18 0 0 0 0 0 0 0 14 20 20 20 15 14
22 18 0 0 0 0 0 11 12 13 0 0 0 0 0 0 0 0 0 0 0 0 0 0 0 0 0 0 0 0 0 0 0 0 0 0 0 0 0 0 0 0 0 0 0 0 0 0 0 0 0 0 0 0 0 0 0 0 0 0 0 14 20 20 20 20 20 20 20 20 20 20 20 20 20 20 20 20 20 20 20 20 20 20 22 18 0 0 0 0 0 0 0 0 14 20 20 22 18 14
15 0 0 11 12 12 12 25 20 24 12 13 0 0 0 0 0 0 0 0 0 0 0 0 0 0 0 0 0 0 0 0 0 0 0 0 0 0 0 0 0 0 0 0 0 0 0 0 0 0 0 0 0 0 0 0 0 0 0 0 0 14 20 20 20 20 20 20 20 20 20 20 20 20 20 20 20 20 20 20 20 20 20 20 15 0 0 0 0 0 0 0 0 0 16 17 17 18 0 14
15 11 12 25 20 20 20 20 20 20 20 24 13 0 0 0 0 0 0 0 0 0 0 0 0 0 0 0 0 0 0 0 0 0 0 0 0 0 0 0 0 0 0 0 0 0 0 0 0 0 0 0 0 0 0 0 0 0 0 0 0 14 20 20 20 20 20 20 20 20 20 20 20 20 20 20 20 20 20 20 20 20 22 17 18 0 0 0 0 0 0 0 0 0 0 0 0 0 0 14
15 14 20 20 20 20 20 20 20 20 20 20 24 13 0 0 0 0 0 0 0 0 0 0 0 0 0 0 0 0 0 0 0 0 0 0 0 0 0 0 0 0 0 0 0 0 0 0 0 0 0 0 0 0 0 0 0 0 0 0 0 16 23 20 20 20 20 20 20 20 20 20 20 20 20 20 20 20 20 20 20 22 18 0 0 0 0 0 0 0 0 0 0 0 0 0 0 0 0 14
24 25 20 20 20 20 20 20 20 20 20 20 20 24 13 0 0 0 0 0 0 0 0 0 0 0 0 0 0 0 0 0 0 0 0 0 0 0 0 0 0 0 0 0 0 0 0 0 0 0 0 0 0 0 0 0 0 0 0 0 0 0 14 20 20 20 20 20 20 20 20 20 20 20 20 20 20 20 22 17 17 18 0 0 0 0 0 0 0 0 0 0 0 0 0 0 0 0 11 25
20 20 20 20 20 20 20 22 23 20 20 20 20 20 24 13 0 0 0 0 0 0 0 0 0 0 0 0 0 0 0 0 0 0 0 0 0 0 0 0 0 0 0 0 0 0 0 0 0 0 0 0 0 0 0 0 0 0 0 0 0 0 16 23 20 20 20 20 20 20 20 20 20 20 20 20 20 22 18 0 0 0 0 0 0 0 0 0 0 0 0 0 0 0 0 0 0 11 25 20
20 20 20 20 20 20 20 15 14 20 20 20 20 20 20 24 13 0 0 0 0 0 0 0 0 0 0 0 0 0 0 0 0 0 0 0 0 0 0 0 0 0 0 0 0 0 0 0 0 0 0 0 0 0 0 0 0 0 0 0 0 0 0 16 17 17 23 20 20 20 20 20 20 20 20 22 17 18 0 0 0 0 0 0 0 0 0 0 0 0 0 0 0 0 0 0 11 25 20 20
20 20 20 20 20 20 22 18 16 17 23 20 20 20 20 20 24 13 0 0 0 0 0 0 0 0 0 0 0 0 0 0 0 0 0 0 0 0 0 0 0 0 0 0 0 0 0 0 0 0 0 0 0 0 0 0 0 0 0 0 0 0 0 0 0 0 16 23 20 20 22 17 17 17 17 18 0 0 0 0 0 0 0 0 0 0 0 0 0 0 0 0 0 0 0 11 25 20 20 20
20 22 17 17 17 23 15 0 0 0 16 23 20 20 20 20 20 24 13 0 0 0 0 0 0 0 0 0 0 0 0 0 0 0 0 0 0 0 0 0 0 0 0 0 0 0 0 0 0 0 0 0 0 0 0 0 0 0 0 0 0 0 0 0 0 0 0 14 20 20 24 13 0 0 0 0 0 0 0 0 0 0 0 0 0 0 0 0 0 0 0 0 0 0 0 14 20 20 20 20
20 24 12 12 13 14 24 12 12 13 0 14 20 20 20 20 20 20 24 13 0 0 0 0 0 0 0 0 0 0 0 0 0 0 0 0 0 0 0 0 0 0 0 0 0 0 0 0 0 0 0 0 0 0 0 0 0 0 0 0 0 0 0 0 0 0 0 14 20 20 20 24 13 0 0 0 0 0 0 0 0 0 0 0 0 0 0 0 0 0 0 0 0 0 0 16 23 20 20 20
20 22 23 20 24 25 20 20 20 15 0 14 20 20 20 20 20 20 20 24 13 0 0 0 0 0 0 0 0 0 0 0 0 0 0 0 0 0 0 0 0 0 0 0 0 0 0 0 0 0 0 0 0 0 0 0 0 0 0 0 0 0 0 0 0 0 0 16 23 20 20 20 24 13 0 0 0 0 0 0 0 0 0 0 0 0 0 0 0 0 0 0 0 0 0 0 16 17 23 20
20 15 14 20 20 20 20 20 20 24 12 25 20 20 20 20 20 20 20 20 24 13 0 0 0 0 0 0 0 0 0 0 0 0 0 0 0 0 0 0 0 0 0 0 0 0 0 0 0 0 0 0 0 0 0 0 0 0 0 0 0 0 0 0 0 0 0 0 16 23 20 20 20 24 13 0 0 0 0 0 0 0 0 0 0 0 0 0 0 0 0 0 0 0 0 0 0 0 16 23
20 15 16 23 20 20 20 20 20 20 20 20 20 20 20 20 20 20 20 20 20 24 13 0 0 0 0 0 0 0 0 0 0 0 0 0 0 0 0 0 0 0 0 0 0 0 0 0 0 0 0 0 0 0 0 0 0 0 0 0 0 0 0 0 0 0 0 0 0 16 23 20 20 20 24 13 0 0 0 0 0 0 0 0 0 0 0 0 0 0 0 0 0 0 0 0 11 12 12 25
20 15 0 16 23 20 20 20 22 17 17 17 17 23 20 20 20 20 20 20 20 20 24 13 0 0 0 0 0 0 0 0 0 0 0 0 0 0 0 0 0 0 0 0 0 0 0 0 0 0 0 0 0 0 0 0 0 0 0 0 0 0 0 0 0 0 0 0 0 0 16 23 20 20 20 24 13 0 0 0 0 0 0 0 0 0 0 0 0 0 0 0 0 0 0 11 25 20 20 20
20 24 13 0 16 17 23 20 15 0 0 0 0 16 17 23 20 20 20 20 20 20 20 24 13 0 0 0 0 0 0 0 0 0 0 0 0 0 0 0 0 0 0 0 0 0 0 0 0 0 0 0 0 0 0 0 0 0 0 0 0 0 0 0 0 0 0 0 0 0 0 16 23 20 20 20 24 13 0 0 0 0 0 0 0 0 0 0 0 0 0 0 0 0 0 14 20 22 23 20
20 20 15 0 0 0 16 23 24 12 12 12 13 0 0 16 17 23 20 20 20 20 20 20 24 13 0 0 0 0 0 0 0 0 0 0 0 0 0 0 0 0 0 0 0 0 0 0 0 0 0 0 0 0 0 0 0 0 0 0 0 0 0 0 0 0 0 0 0 0 0 0 16 23 20 20 20 15 0 0 0 0 0 0 0 0 0 0 0 0 0 0 0 0 0 16 17 18 25 20
20 20 24 13 0 0 0 16 17 23 20 20 15 0 0 0 0 16 17 23 20 20 20 20 20 24 13 0 0 0 0 0 0 0 0 0 0 0 0 0 0 0 0 0 0 0 0 0 0 0 0 0 0 0 0 0 0 0 0 0 0 0 0 0 0 0 0 0 0 0 0 0 0 16 23 20 20 15 0 0 0 0 0 0 0 0 0 0 0 0 0 0 0 0 0 11 12 12 20 20
20 20 20 15 0 0 0 0 11 25 20 20 15 0 0 0 0 0 0 16 17 23 20 20 20 20 24 13 0 0 0 0 0 0 0 0 0 0 0 0 0 0 0 0 0 0 0 0 0 0 0 0 0 0 0 0 0 0 0 0 0 0 0 0 0 0 0 0 0 0 0 0 0 0 14 20 22 18 0 0 0 0 0 0 0 0 0 0 0 0 0 0 0 0 11 25 20 20 20 20
20 20 20 15 0 0 0 11 25 20 20 22 18 0 0 0 0 0 11 12 12 25 20 20 20 20 20 24 13 0 0 0 0 0 0 0 0 0 0 0 0 0 0 0 0 0 0 0 0 0 0 0 0 0 0 0 0 0 0 0 0 0 0 0 0 0 0 0 0 0 0 0 0 0 14 20 24 13 0 0 0 0 0 0 0 0 0 0 0 0 0 0 0 11 25 20 20 20 20 20
20 20 20 24 13 0 0 14 20 20 20 15 0 0 0 0 11 12 25 20 20 20 20 20 20 20 20 20 24 13 0 0 0 0 0 0 0 0 0 0 0 0 0 0 0 0 0 0 0 0 0 0 0 0 0 0 0 0 0 0 0 0 0 0 0 0 0 0 0 0 0 0 0 0 14 20 20 24 13 0 0 0 0 0 0 0 0 0 0 0 0 0 11 25 20 20 20 20 20 20
20 20 20 20 15 0 0 14 20 20 20 15 0 0 0 0 16 23 20 20 20 20 20 20 20 20 20 20 20 24 13 0 0 0 0 0 0 0 0 0 0 0 0 0 0 0 0 0 0 0 0 0 0 0 0 0 0 0 0 0 0 0 0 0 0 0 0 0 0 0 0 0 0 0 16 23 20 20 24 13 0 0 0 0 0 0 0 0 0 0 0 11 25 20 20 22 17 23 20 20
20 20 20 20 24 12 13 14 20 22 17 18 0 0 0 0 0 16 17 17 17 17 17 17 17 23 20 20 20 20 24 13 0 0 0 0 0 0 0 0 0 0 0 0 0 0 0 0 0 0 0 0 0 0 0 0 0 0 0 0 0 0 0 0 0 0 0 0 0 0 0 0 0 0 0 16 23 20 20 24 13 0 0 0 0 0 0 0 0 0 11 25 20 20 20 24 13 16 23 20
20 20 20 20 20 20 15 14 20 15 0 0 0 0 0 0 0 0 0 0 0 0 0 0 0 16 23 20 20 20 20 15 0 0 0 0 0 0 0 0 0 0 0 0 0 0 0 0 0 0 0 0 0 0 0 0 0 0 0 0 0 0 0 0 0 0 0 0 0 0 0 0 0 0 0 0 16 23 20 20 24 13 0 0 0 0 0 0 0 0 14 20 20 20 20 20 24 13 14 20
20 20 20 20 20 20 24 25 20 24 12 12 12 13 0 0 0 0 0 0 0 0 0 11 12 12 25 20 20 20 20 15 0 0 0 0 0 0 0 0 0 0 0 0 0 0 0 0 0 0 0 0 0 0 0 0 0 0 0 0 0 0 0 0 0 0 0 0 0 0 0 0 0 0 0 0 0 16 23 20 20 24 13 0 11 12 12 12 13 11 25 20 20 20 20 20 20 15 14 20
20 20 22 23 20 20 20 22 17 23 20 20 20 15 0 0 0 0 0 0 0 0 0 14 20 20 22 17 17 23 20 24 13 0 0 0 0 0 0 0 0 0 0 0 0 0 0 0 0 0 0 0 0 0 0 0 0 0 0 0 0 0 0 0 0 0 0 0 0 0 0 0 0 0 0 0 0 0 14 20 20 20 15 11 25 20 20 20 15 14 20 20 20 20 20 20 20 15 14 20
20 20 15 16 17 23 20 24 13 16 23 20 20 15 0 0 11 12 12 13 0 0 0 16 23 20 24 12 13 14 20 20 15 0 0 0 0 0 0 0 0 0 0 0 0 0 0 0 0 0 0 0 0 0 0 0 0 0 0 0 0 0 0 0 0 0 0 0 0 0 0 0 0 0 0 0 0 0 16 23 20 20 24 25 20 20 20 20 15 16 23 20 20 20 20 20 22 18 14 20
20 20 15 0 0 16 23 20 15 0 16 23 20 15 0 0 14 20 20 24 13 0 0 11 25 20 20 20 12 25 20 20 15 0 0 0 0 0 0 0 0 0 0 0 0 0 0 0 0 0 0 0 0 0 0 0 0 0 0 0 0 0 0 0 0 0 0 0 0 0 0 0 0 0 0 0 0 0 11 25 20 20 20 20 20 20 22 17 18 0 16 17 17 23 20 22 18 11 25 20
20 20 24 12 13 11 25 20 15 0 0 14 20 24 13 11 25 20 20 20 15 0 0 14 20 20 20 20 20 20 20 20 15 0 0 0 0 0 0 0 0 0 0 0 0 0 0 0 0 0 0 0 0 0 0 0 0 0 0 0 0 0 0 0 0 0 0 0 0 0 0 0 0 0 0 0 11 12 25 20 20 20 20 20 20 22 18 0 0 0 0 0 0 14 20 24 12 25 20 20
20 20 20 20 15 14 20 20 24 12 12 25 20 20 24 25 22 17 23 20 15 0 0 16 23 20 20 20 20 20 20 22 18 0 0 0 0 0 0 0 0 0 0 0 0 0 0 0 0 0 0 0 0 0 0 0 0 0 0 0 0 0 0 0 0 0 0 0 0 0 0 0 0 0 0 11 25 20 20 20 20 20 20 20 22 18 0 0 0 0 0 11 12 25 20 20 20 20 20 20
20 20 20 20 24 25 22 17 23 20 20 20 20 20 20 22 18 0 14 20 24 13 11 12 25 20 20 20 20 20 22 18 0 0 0 0 0 0 0 0 0 0 0 0 0 0 0 0 0 0 0 0 0 0 0 0 0 0 0 0 0 0 0 0 0 0 0 0 0 0 0 0 0 0 11 25 20 20 20 20 20 20 20 20 24 13 0 0 0 0 11 25 20 20 20 20 20 20 20 20
20 20 20 20 20 20 15 0 14 20 20 20 20 20 22 18 0 11 25 20 20 24 25 20 20 20 20 20 20 20 15 0 0 0 0 0 0 0 0 0 0 0 0 0 0 0 0 0 0 0 0 0 0 0 0 0 0 0 0 0 0 0 0 0 0 0 0 0 0 0 0 0 0 11 25 20 20 20 20 20 20 20 20 20 20 24 13 0 0 11 25 20 20 20 20 20 20 20 20 20
20 20 20 20 20 22 18 0 16 23 20 20 20 20 24 12 13 14 20 20 20 20 20 20 20 20 20 20 20 20 15 0 0 0 0 0 0 0 0 0 0 0 0 0 0 0 0 0 0 0 0 0 0 0 0 0 0 0 0 0 0 0 0 0 0 0 0 0 0 0 0 11 12 25 20 20 20 20 20 20 20 20 20 20 20 20 15 0 11 25 20 20 20 20 20 20 20 20 20 20
20 20 20 20 22 18 0 0 0 16 23 20 20 20 20 20 15 14 20 20 20 0 20 20 20 20 20 20 22 17 18 0 0 0 0 0 0 0 0 0 0 0 0 0 0 0 0 0 0 0 0 0 0 0 0 0 0 0 0 0 0 0 0 0 0 0 0 0 0 0 0 14 20 20 20 20 20 20 20 20 20 20 20 20 20 20 15 0 14 20 20 20 20 20 20 20 20 20 20 20
20 20 20 20 15 0 0 0 0 0 16 23 20 20 20 20 24 25 20 20 0 0 0 0 20 20 20 20 15 0 0 0 0 0 0 0 0 0 0 0 0 0 0 0 0 0 0 0 0 0 0 0 0 0 0 0 0 0 0 0 0 0 0 0 0 0 0 0 0 0 11 25 20 20 20 20 20 20 20 20 20 20 20 20 20 20 15 0 16 23 20 20 20 20 20 20 20 20 20 20
20 20 20 20 15 0 0 0 0 0 0 16 17 23 20 20 20 20 20 20 0 0 0 20 20 20 22 17 18 0 0 0 0 0 0 0 0 0 0 0 0 0 0 0 0 0 0 0 0 0 0 0 0 0 0 0 0 0 0 0 0 0 0 0 0 0 0 0 0 0 14 20 20 20 20 20 20 20 20 20 20 20 20 22 17 17 18 0 0 14 20 20 20 20 20 20 20 20 20 20
20 20 20 22 18 0 0 0 0 0 0 0 0 16 17 23 20 20 20 20 0 0 0 20 20 20 15 0 0 0 0 0 0 0 0 0 0 0 0 0 0 0 0 0 0 0 0 0 0 0 0 0 0 0 0 0 0 0 0 0 0 0 0 0 0 0 0 0 0 0 14 20 20 20 20 20 20 20 20 20 20 20 20 24 13 0 0 0 11 25 20 20 20 20 20 20 20 20 20 20
20 20 22 18 0 0 0 0 0 0 0 0 0 0 0 16 17 23 20 20 0 0 20 20 20 20 15 0 0 0 0 0 0 0 0 0 0 0 0 0 0 0 0 0 0 0 0 0 0 0 0 0 0 0 0 0 0 0 0 0 0 0 0 0 0 0 0 0 0 11 25 20 20 20 20 20 20 20 20 20 20 20 20 20 24 13 0 11 25 20 20 20 20 20 20 20 20 20 20 20
20 20 15 0 0 0 0 0 0 0 0 0 0 0 0 0 11 25 20 20 20 20 20 20 20 20 24 12 13 0 0 0 0 0 0 0 0 0 0 0 0 0 0 0 0 0 0 0 0 0 0 0 0 0 0 0 0 0 0 0 0 0 0 0 0 0 0 0 11 25 20 20 20 20 20 20 20 20 20 20 20 20 20 20 20 24 13 14 20 20 20 20 20 20 20 20 20 20 20 20
20 20 15 0 0 0 0 0 0 0 0 0 0 0 0 0 14 20 20 22 23 20 20 20 20 20 20 20 24 13 0 0 0 0 0 0 0 0 0 0 0 0 0 0 0 0 0 0 0 0 0 0 0 0 0 0 0 0 0 0 0 0 0 0 0 0 0 0 14 20 20 20 20 20 20 20 20 20 20 20 20 20 20 20 20 20 15 14 20 20 20 20 20 20 20 20 20 20 20 20
20 20 15 0 0 0 0 0 0 0 0 0 0 0 0 0 16 17 17 18 16 23 20 20 20 20 20 20 20 15 0 0 0 0 0 0 0 0 0 0 0 0 0 0 0 0 0 0 0 0 0 0 0 0 0 0 0 0 0 0 0 0 0 0 0 0 11 12 25 20 20 20 20 20 20 20 20 20 20 20 20 20 20 20 20 20 24 25 20 20 20 20 20 20 20 20 20 20 20 20
20 20 24 12 13 0 0 0 0 0 0 0 0 0 0 0 0 0 0 0 0 16 23 20 20 20 20 20 20 24 12 13 0 0 0 0 0 0 0 0 0 0 0 0 0 0 0 0 0 0 0 0 0 0 0 0 0 0 0 0 0 0 0 0 0 11 25 20 20 20 20 20 20 20 20 20 20 20 20 20 20 20 20 20 20 20 20 20 20 20 20 20 20 20 20 20 20 20 20 20
20 20 20 20 15 0 0 0 0 0 0 0 11 12 12 13 0 0 0 0 0 0 14 20 20 20 20 20 20 20 20 24 13 0 0 0 0 0 0 0 0 0 0 0 0 0 0 0 0 0 0 0 0 0 0 0 0 0 0 0 0 0 0 0 0 14 20 20 20 20 20 20 20 20 20 20 20 20 20 20 20 20 20 20 20 20 20 20 20 20 20 20 20 20 20 20 20 20 20 20
20 20 20 20 15 0 0 0 0 11 12 12 25 20 20 24 12 13 0 0 0 11 25 20 20 20 20 20 20 20 20 20 24 12 12 13 0 0 0 0 0 0 0 0 0 0 0 0 0 0 0 0 0 0 0 0 0 0 0 0 0 0 0 0 0 14 20 20 20 20 20 20 20 20 20 20 20 20 20 20 20 20 20 20 20 20 20 20 20 20 20 20 20 20 20 20 20 20 20 20
20 20 20 20 24 13 0 0 11 25 20 20 20 20 20 20 20 15 0 0 11 25 20 20 20 20 20 20 20 20 20 20 20 20 20 24 12 13 0 0 0 0 0 0 0 0 0 0 0 0 0 0 0 0 0 0 0 0 0 0 0 0 0 0 11 25 20 20 20 20 20 20 20 20 20 20 20 20 20 20 20 20 20 20 20 20 20 20 20 20 20 20 20 20 20 20 20 20 20 20
20 20 20 20 20 24 12 12 25 20 20 20 20 20 20 22 17 18 0 0 14 20 20 20 20 20 20 20 20 20 20 20 20 20 20 20 20 24 13 0 0 0 0 0 0 0 0 0 0 0 0 0 0 0 0 0 0 0 0 0 0 0 0 11 25 20 20 20 20 20 20 20 20 20 20 20 20 20 20 20 20 20 20 20 20 20 20 20 20 20 20 20 20 20 20 20 20 20 20 20
20 20 20 20 20 20 20 20 20 20 20 20 20 20 22 18 0 0 0 0 14 20 20 20 20 20 20 20 20 20 20 20 20 20 20 20 20 20 24 12 13 0 0 0 0 0 0 0 0 0 0 0 0 0 0 0 0 0 0 0 0 11 12 25 20 20 20 20 20 20 20 20 20 20 20 20 20 20 20 20 20 20 20 20 20 20 20 20 20 20 20 20 20 20 20 20 20 20 20 20
20 20 20 20 20 20 20 20 20 20 20 20 20 20 15 0 0 0 0 0 14 20 20 20 20 20 20 20 20 20 20 20 20 20 20 20 20 20 20 20 15 0 11 12 12 13 0 0 0 0 0 0 0 0 0 0 0 11 12 12 12 25 20 20 20 20 20 20 20 20 20 20 20 20 20 20 20 20 20 20 20 20 20 20 20 20 20 20 20 20 20 20 20 20 20 20 20 20 20 20
20 20 20 20 20 20 20 20 20 20 20 20 20 20 15 0 0 0 0 0 16 17 23 20 20 20 20 20 20 20 20 20 20 20 20 20 20 20 20 22 18 0 14 20 20 24 12 13 0 0 0 0 0 0 0 11 12 25 20 20 20 20 20 20 20 20 20 20 20 20 20 20 20 20 20 20 20 20 20 20 20 20 20 20 20 20 20 20 20 20 20 20 20 20 20 20 20 20 20 20
20 20 20 20 20 20 20 20 20 20 20 20 20 20 24 13 0 0 0 0 0 0 14 20 20 20 20 20 20 20 20 20 20 20 20 20 20 22 17 18 0 11 25 20 20 20 20 24 12 13 0 0 0 0 0 14 20 20 20 20 20 20 20 20 20 20 20 20 20 20 20 20 20 20 20 20 20 20 20 20 20 20 20 20 20 20 20 20 20 20 20 20 20 20 20 20 20 20 20 20
20 20 20 20 20 20 20 20 20 20 20 20 20 20 20 24 13 0 0 0 0 11 25 20 20 20 20 20 20 20 20 20 20 20 20 20 20 15 0 0 0 14 20 20 20 20 20 20 20 15 0 11 13 0 0 14 20 20 20 20 20 20 20 20 20 20 20 20 20 20 20 20 20 20 20 20 20 20 20 20 20 20 20 20 20 20 20 20 20 20 20 20 20 20 20 20 20 20 20 20
20 20 20 20 20 20 20 20 20 20 20 20 20 20 20 20 24 12 13 0 0 14 20 20 20 20 20 20 20 20 20 20 20 20 20 20 20 24 13 0 11 25 20 20 20 20 20 20 20 15 11 25 15 0 0 14 20 20 20 20 20 20 20 20 20 20 20 20 20 20 20 20 20 20 20 20 20 20 20 20 20 20 20 20 20 20 20 20 20 20 20 20 20 20 20 20 20 20 20 20
20 20 20 20 20 20 20 20 20 20 20 20 20 20 20 20 20 20 24 12 12 25 20 20 20 20 20 20 20 20 20 20 20 20 20 20 20 20 24 12 25 20 20 20 20 20 20 20 20 15 14 20 24 13 11 25 20 20 20 20 20 20 20 20 20 20 20 20 20 20 20 20 20 20 20 20 20 20 20 20 20 20 20 20 20 20 20 20 20 20 20 20 20 20 20 20 20 20 20 20
20 20 20 20 20 20 20 20 20 20 20 20 20 20 20 20 20 20 20 20 20 20 20 20 20 20 20 20 20 20 20 20 20 20 20 20 20 20 20 20 20 20 20 20 20 20 20 20 20 15 14 20 20 24 25 20 20 20 20 20 20 20 20 20 20 20 20 20 20 20 20 20 20 20 20 20 20 20 20 20 20 20 20 20 20 20 20 20 20 20 20 20 20 20 20 20 20 20 20 20
20 20 20 20 20 20 20 20 20 20 20 20 20 20 20 20 20 20 20 20 20 20 20 20 20 20 20 20 20 20 20 20 20 20 20 20 20 20 20 20 20 20 20 20 20 20 20 20 22 18 16 23 20 20 20 20 20 20 20 20 20 20 20 20 20 20 20 20 20 20 20 20 20 20 20 20 20 20 20 20 20 20 20 20 20 20 20 20 20 20 20 20 20 20 20 20 20 20 20 20
20 20 20 20 20 20 20 20 20 20 20 20 20 20 20 20 20 20 20 20 20 20 20 20 20 20 20 20 20 20 20 20 20 20 20 20 20 20 20 20 20 20 20 20 20 20 20 20 15 0 0 14 20 20 20 20 20 20 20 20 20 20 20 20 20 20 20 20 20 20 20 20 20 20 20 20 20 20 20 20 20 20 20 20 20 20 20 20 20 20 20 20 20 20 20 20 20 20 20 20
20 20 20 20 20 20 20 20 20 20 20 20 20 20 20 20 20 20 20 20 20 20 20 20 20 20 20 20 20 20 20 20 20 20 20 20 20 20 20 20 20 20 20 20 20 20 20 20 15 0 0 14 20 20 20 20 20 20 20 20 20 20 20 20 20 20 20 20 20 20 20 20 20 20 20 20 20 20 20 20 20 20 20 20 20 20 20 20 20 20 20 20 20 20 20 20 20 20 20 20
20 20 20 20 20 20 20 20 20 20 20 20 20 20 20 20 20 20 20 20 20 20 20 20 20 20 20 20 20 20 20 20 20 20 20 20 20 20 20 20 20 20 20 20 20 20 20 20 24 12 12 25 20 20 20 20 20 20 20 20 20 20 20 20 20 20 20 20 20 20 20 20 20 20 20 20 20 20 20 20 20 20 20 20 20 20 20 20 20 20 20 20 20 20 20 20 20 20 20 20